1111111111111111111111111111111111
1E00000000000000000000000000000111
101001010010000P101001000000010111
1010010010101010001001000000010101
1000010000000C00000000000000000001
1111111111111111111111111111111111
