1111111111111
1000E000C00P1
1000000010101
1000000010101
1000000000001
1111111111111