1111111111111111111111111111111111
10000000000000000E00000000000000P1
1010010100000000101001000000010111
1010010010101110001001000000010101
1000010000001C10000000000000000001
1111111111111111111111111111111111