1111111111111
1000E000000P1
1000000010111
1000C00010101
1000000000001
1111111111111