1111111111111111111
1P11100011110001111
1001000100010001001
1001000100010001001
1001111001111000111
1001000000010000001
1001000000010000001
1C0000000000C0000E1
1111111111111111111