111111111111111111111111111111
101000000000001EPC000000000101
111111111111111111111111111111
