1111111111111111111111111111111111111111
100000000000000C00000C000000000001000011
1010010100101010101010101010101000101011
1010010010101010001001000000000000101011
1P0000000C000000000000000C00000000000001
1111111111111111111111111111111111111101
1010000000000000000000000000000000000001
1010000000000000000000000000000000000011
1010000000000000000000000000000000000011
1010000000000000000000000000000000000011
1010101010101010101010101010101010101011
1010101010101010101010101010101010101011
1010000000000000000000000000000000000011
1010000000000000000000000000000000000011
1C00000000000000000000000000000000000E11
1111111111111111111111111111111111111111
1111111111111111111111111111111111111111
1111111111111111111111111111111111111111
1111111111111111111111111111111111111111
1111111111111111111111111111111111111111
1111111111111111111111111111111111111111
